&&&&&&&&&&&&&&&&&&&&&&&&&&&&&&&&&&&&&&&&
########################################
#p  s  F* *  1 * 2 *  * * *   ##########
# # # #*# # #*#*# # # #*#*#*# ##########
#   B  b  ***  *  1   * 2 * * ##########
# # # # # #*# # #*#*# # # # #*##########
#f         x **  *  *   1     ##########
# # # # # # # # # #*# #*# # # ##########
#*  *   3  *  *      *        ##########
# # # # #*# # # #*#*# # # # # ##########
#*    **  *       *           ##########
# #*# # # # # # #*# # # # # # ##########
#   #       *   *  *          ##########
########################################